WWWWWWWWWWWWWWWWWWWWWWWWWWW
WD   WDDDWDWD D D D W DDDDW
W  D  WDW D D  DDDDDDD DWDW
W  D D D WDDDDD   D   WDW W
W D  D WDD D  DWWW  D     W
WD   W W WWW  W  D D   DD W
WDW    W  D   D W W  DD D W
WDWDDD  W DDDDDD  WWWD DD W
WDDDDD D DWD DW D  WDWD DWW
WDWD  WDW D   DDD DDD DDDDW
WWWWWWWWWWWWWWWWWWWWWWWWWWW